0 0 0 0 0 0 0 0 0 0 0 0 0 0 0 8 9 4 4 4 10 11 0 0 0
0 0 0 0 0 0 0 0 0 0 0 0 0 0 0 26 22 22 22 22 22 30 0 0 0
0 0 0 0 0 0 0 0 0 0 0 0 0 0 0 21 22 27 28 29 22 23 0 0 0
0 0 0 0 0 0 0 0 0 0 0 0 0 0 0 21 22 23 0 21 22 23 0 0 0
0 0 0 0 0 0 0 0 0 0 0 0 0 0 0 21 22 23 0 21 22 23 0 0 0
0 0 0 0 0 0 0 0 0 0 0 0 0 0 0 21 22 23 0 21 22 23 0 0 0
0 8 9 4 4 4 4 4 4 4 4 4 88 4 4 47 22 23 0 21 22 23 0 0 0
0 26 22 22 22 22 22 22 22 22 22 22 89 22 22 22 22 48 0 21 22 23 0 0 0
0 21 22 27 28 28 28 28 28 28 28 28 90 28 28 28 65 66 0 21 22 23 0 0 0
0 21 22 23 0 0 0 0 0 0 0 0 0 0 0 0 0 0 0 21 22 23 0 0 0
0 21 22 23 0 0 0 0 0 0 0 0 0 0 0 0 0 0 0 21 22 23 0 0 0
0 21 22 23 0 0 0 0 0 0 0 0 0 0 0 0 0 0 0 21 22 23 0 0 0
0 21 22 46 4 4 4 4 4 4 4 4 4 4 4 4 4 4 4 47 22 23 0 0 0
0 45 22 22 22 22 22 22 22 22 22 22 22 22 22 22 22 22 22 22 22 23 0 0 0
0 63 64 28 28 28 28 28 28 28 28 28 28 28 28 28 28 28 28 28 28 25 0 0 0